1111111111111
1C01000000001
1000011111001
100PP10E00001
1111111111111