1111111111111
1C01000000001
1000011111001
100P11E000001
1111111111111
