1111111111111
1C01000000001
1000011111001
100P110000001
1111111111111